Afghan	NAT
Albanian	NAT
Algerian	NAT
Andorran	NAT
Angolan	NAT
Argentinian	NAT
Armenian	NAT
Australian	NAT
Austrian	NAT
Azerbaijani	NAT
Bahamian	NAT
Bahraini	NAT
Bangladeshi	NAT
Barbadian	NAT
Belarusian	NAT
Belarusan	NAT
Belgian	NAT
Belizean	NAT
Beninese	NAT
Bhutanese	NAT
Bolivian	NAT
Bosnian	NAT
Botswanan	NAT
Brazilian	NAT
British	NAT
Bruneian	NAT
Bulgarian	NAT
Burkinese	NAT
Burmese	NAT
Burundian	NAT
Cambodian	NAT
Cameroonian	NAT
Canadian	NAT
Cape Verdean	NAT
Chadian	NAT
Chilean	NAT
Chinese	NAT
Colombian	NAT
Congolese	NAT
Costa Rican	NAT
Croatian	NAT
Croat	NAT
Cuban	NAT
Cypriot	NAT
Czech	NAT
Danish	NAT
Djiboutian	NAT
Dominican	NAT
Dominican	NAT
Ecuadorean	NAT
Egyptian	NAT
Salvadorean	NAT
English	NAT
Eritrean	NAT
Estonian	NAT
Ethiopian	NAT
Fijian	NAT
Finnish	NAT
French	NAT
Gabonese	NAT
Gambian	NAT
Georgian	NAT
German	NAT
Ghanaian	NAT
Greek	NAT
Grenadian	NAT
Guatemalan	NAT
Guinean	NAT
Guyanese	NAT
Haitian	NAT
Dutch	NAT
Honduran	NAT
Hungarian	NAT
Icelandic	NAT
Indian	NAT
Indonesian	NAT
Iranian	NAT
Iraqi	NAT
Irish	NAT
Italian	NAT
Jamaican	NAT
Japanese	NAT
Jordanian	NAT
Kazakh	NAT
Kenyan	NAT
Kuwaiti	NAT
Laotian	NAT
Latvian	NAT
Lebanese	NAT
Liberian	NAT
Libyan	NAT
Lithuanian	NAT
Madagascan	NAT
Macedonian	NAT
Malagasy	NAT
Malawian	NAT
Malaysian	NAT
Maldivian	NAT
Malian	NAT
Maltese	NAT
Mauritanian	NAT
Mauritian	NAT
Mexican	NAT
Moldovan	NAT
Monégasque	NAT
Monacan	NAT
Mongolian	NAT
Montenegrin	NAT
Moroccan	NAT
Mozambican	NAT
Namibian	NAT
Nepalese	NAT
Dutch	NAT
Nicaraguan	NAT
Nigerien	NAT
Nigerian	NAT
North Korean	NAT
Norwegian	NAT
Omani	NAT
Pakistani	NAT
Panamanian	NAT
Guinean	NAT
Papua New Guinean	NAT
Paraguayan	NAT
Peruvian	NAT
Philippine	NAT
Polish	NAT
Portuguese	NAT
Qatari	NAT
Romanian	NAT
Russian	NAT
Rwandan	NAT
Saudi Arabian	NAT
Saudi	NAT
Scottish	NAT
Senegalese	NAT
Serb or Serbian	NAT
Seychellois	NAT
Sierra Leonian	NAT
Singaporean	NAT
Slovak	NAT
Slovene	NAT
Slovenian	NAT
Somali	NAT
South African	NAT
South Korean	NAT
Spanish	NAT
Sri Lankan	NAT
Sudanese	NAT
Surinamese	NAT
Swazi	NAT
Swedish	NAT
Swiss	NAT
Syrian	NAT
Taiwanese	NAT
Tajik or Tadjik	NAT
Tanzanian	NAT
Thai	NAT
Togolese	NAT
Tunisian	NAT
Turkish	NAT
Turkmen	NAT
Turkoman	NAT
Tuvaluan	NAT
Ugandan	NAT
Ukrainian	NAT
Uruguayan	NAT
Uzbek	NAT
Vanuatuan	NAT
Venezuelan	NAT
Vietnamese	NAT
Welsh	NAT
Western Samoan	NAT
Yemeni	NAT
Yugoslav	NAT
Zaïrean	NAT
Zambian	NAT
Zimbabwean	NAT
Afghans	NAT
Albanians	NAT
Algerians	NAT
Americans	NAT
Andorrans	NAT
Angolans	NAT
Argentines	NAT
Armenians	NAT
Aromanians	NAT
Arubans	NAT
Australians	NAT
Austrians	NAT
Azerbaijanis	NAT
Bahamians	NAT
Bahrainis	NAT
Bangladeshis	NAT
Barbadians	NAT
Basotho	NAT
Basques	NAT
Belarusians	NAT
Belgians	NAT
Belizeans	NAT
Bermudians	NAT
Boers	NAT
Bosniaks	NAT
Brazilians	NAT
Bretons	NAT
British	NAT
British Virgin Islanders	NAT
Bruneians	NAT
Bulgarians	NAT
Macedonian Bulgarians	NAT
Burkinabès	NAT
Burundians	NAT
Cambodians	NAT
Cameroonians	NAT
Canadians	NAT
Catalans	NAT
Cape Verdeans	NAT
Chadians	NAT
Chileans	NAT
Chinese	NAT
Colombians	NAT
Comorians	NAT
Congolese	NAT
Croatians	NAT
Cubans	NAT
Cypriots	NAT
Turkish Cypriots	NAT
Czechs	NAT
Danes	NAT
Dominicans 	NAT
Dominicans 	NAT
Dutch	NAT
East Timorese	NAT
Ecuadorians	NAT
Egyptians	NAT
Emiratis	NAT
English	NAT
Eritreans	NAT
Estonians	NAT
Ethiopians	NAT
Falkland Islanders	NAT
Faroese	NAT
Finns	NAT
Finnish Swedish	NAT
Fijians	NAT
Filipinos	NAT
French citizens	NAT
Georgians	NAT
Germans	NAT
Baltic Germans	NAT
Ghanaians	NAT
Gibraltar	NAT
Greeks	NAT
Greek Macedonians	NAT
Grenadians	NAT
Guatemalans	NAT
Guianese 	NAT
Guineans	NAT
Guinea-Bissau nationals	NAT
Guyanese	NAT
Haitians	NAT
Hondurans	NAT
Hong Kong	NAT
Hungarians	NAT
Icelanders	NAT
I-Kiribati	NAT
Indians	NAT
Indonesians	NAT
Iranians	NAT
Iraqis	NAT
Irish	NAT
Israelis	NAT
Italians	NAT
Ivoirians	NAT
Jamaicans	NAT
Japanese	NAT
Jordanians	NAT
Kazakhs	NAT
Kenyans	NAT
Koreans	NAT
Kosovars	NAT
Kurds	NAT
Kuwaitis	NAT
Kyrgyzs	NAT
Lao	NAT
Latvians	NAT
Lebanese	NAT
Liberians	NAT
Libyans	NAT
Liechtensteiners	NAT
Lithuanians	NAT
Luxembourgers	NAT
Macao	NAT
Macedonians	NAT
Malagasy	NAT
Malaysians	NAT
Malawians	NAT
Maldivians	NAT
Malians	NAT
Maltese	NAT
Manx	NAT
Mauritians	NAT
Mexicans	NAT
Moldovans	NAT
Moroccans	NAT
Mongolians	NAT
Montenegrins	NAT
Namibians	NAT
Nepalese	NAT
New Zealanders	NAT
Nicaraguans	NAT
Nigeriens	NAT
Nigerians	NAT
Norwegians	NAT
Pakistanis	NAT
Palauans	NAT
Palestinians	NAT
Panamanians	NAT
Papua New Guineans	NAT
Paraguayans	NAT
Peruvians	NAT
Poles	NAT
Portuguese	NAT
Puerto Ricans	NAT
Quebecers	NAT
Réunionnais	NAT
Romanians	NAT
Russians	NAT
Baltic Russians	NAT
Rwandans	NAT
Salvadorans	NAT
São Tomé and Príncipe	NAT
Saudis	NAT
Scots	NAT
Senegalese	NAT
Serbs	NAT
Sierra Leoneans	NAT
Singaporeans	NAT
Sindhian	NAT
Slovaks	NAT
Slovenes	NAT
Somalis	NAT
Somalilanders	NAT
South Africans	NAT
Spaniards	NAT
Sri Lankans	NAT
St Lucians	NAT
Sudanese	NAT
Surinamese	NAT
Swedes	NAT
Swiss	NAT
Syriacs	NAT
Syrians	NAT
Tajik	NAT
Taiwanese	NAT
Tanzanians	NAT
Thais	NAT
Tibetans	NAT
Tobagonians	NAT
Trinidadians	NAT
Tunisians	NAT
Turks	NAT
Tuvaluans	NAT
Ugandans	NAT
Ukrainians	NAT
Uruguayans	NAT
Uzbeks	NAT
Vanuatuans	NAT
Venezuelans	NAT
Vietnamese	NAT
Welsh	NAT
Yemenis	NAT
Zambians	NAT
Zimbabweans	NAT
Assyrians	NAT
Azeris	NAT
Basques	NAT
Bengalis	NAT
Berbers	NAT
Boers	NAT
Buryats	NAT
Cajuns	NAT
Catalans	NAT
Celts	NAT
Chuvash	NAT
Greeks	NAT
Han Chinese	NAT
Hispanic and Latino Americans	NAT
Hutus	NAT
Igbo	NAT
Indigenous Australians	NAT
Indigenous people of the Americas	NAT
First Nations	NAT
Huaorani people	NAT
Inuit	NAT
Canadian Inuit	NAT
Greenlandic Inuit	NAT
Métis people	NAT
Native Americans	NAT
Japanese	NAT
Karen	NAT
Kodavas	NAT
Kurds	NAT
Macedonians	NAT
Malays	NAT
Mongolians	NAT
Roma	NAT
Samis	NAT
Sikhs	NAT
Silesians	NAT
Sinhalese	NAT
Syriacs	NAT
Kannadigas	NAT
Tamils	NAT
Tatars	NAT
Tutsis	NAT
Physical sports	SPORT
Air sports	SPORT
Aerobatics	SPORT
Air racing	SPORT
Cluster ballooning	SPORT
Hopper ballooning	SPORT
Wingsuit flying	SPORT
Gliding	SPORT
Hang gliding	SPORT
Powered hang glider	SPORT
Human powered aircraft	SPORT
Model aircraft	SPORT
Parachuting	SPORT
Banzai skydiving	SPORT
BASE jumping	SPORT
Skydiving	SPORT
Skysurfing	SPORT
Wingsuit flying	SPORT
Paragliding	SPORT
Powered paragliding	SPORT
Paramotoring	SPORT
Ultralight aviation	SPORT
Archery	SPORT
Field archery	SPORT
Flight archery	SPORT
Gungdo	SPORT
Indoor archery	SPORT
Kyudo	SPORT
Popinjay	SPORT
Target archery	SPORT
Ball-over-net games	SPORT
Badminton	SPORT
Ball badminton	SPORT
Biribol	SPORT
Bossaball	SPORT
Fistball	SPORT
Footbag net	SPORT
Football tennis	SPORT
Footvolley	SPORT
Hooverball	SPORT
Padel	SPORT
Peteca	SPORT
Pickleball	SPORT
Platform tennis	SPORT
Sepak takraw	SPORT
Sipa	SPORT
Throwball	SPORT
Volleyball	SPORT
Beach volleyball	SPORT
Water volleyball	SPORT
Paralympic volleyball	SPORT
Wallyball	SPORT
Basketball family	SPORT
Basketball	SPORT
Beach basketball	SPORT
Deaf basketball	SPORT
Streetball	SPORT
Water basketball	SPORT
Wheelchair basketball	SPORT
Cestoball	SPORT
Korfball	SPORT
Netball	SPORT
Fastnet	SPORT
Indoor netball	SPORT
Ringball	SPORT
Slamball	SPORT
Bat-and-ball (safe haven)	SPORT
Awaiting a pitch: batter, catcher, and umpire in baseball	SPORT
Baseball	SPORT
Softball	SPORT
Slow pitch	SPORT
Fast-pitch softball	SPORT
16-inch softball	SPORT
Bat and trap	SPORT
British baseball - four posts	SPORT
Brännboll - four bases	SPORT
Corkball - four bases (no base-running)	SPORT
Cricket - two creases	SPORT
Indoor cricket	SPORT
Limited overs cricket	SPORT
One Day International	SPORT
Test cricket	SPORT
Twenty20	SPORT
Danish longball	SPORT
Kickball	SPORT
Kilikiti	SPORT
Lapta – two salos (bases)	SPORT
The Massachusetts Game – four bases	SPORT
Matball	SPORT
Oina	SPORT
Old cat – variable	SPORT
Over-the-line – qv	SPORT
Palant	SPORT
Pesäpallo – four bases	SPORT
Punchball	SPORT
Rounders – four bases or posts	SPORT
Scrub baseball – four bases (not a team game per se)	SPORT
Stickball – variable	SPORT
Stool ball – two stools	SPORT
Tee-ball	SPORT
Town ball – variable	SPORT
Vigoro – two wickets	SPORT
Wireball	SPORT
Wiffleball	SPORT
Baton twirling	SPORT
Baton twirling	SPORT
Acro Sports	SPORT
Cheerleading	SPORT
gymnastics	SPORT
acro	SPORT
dancing	SPORT
ball acro	SPORT
Ballet	SPORT
Board sports	SPORT
Snowboard figure at the 2008 Shakedown	SPORT
Surfing in Hawaii	SPORT
Skateboarding	SPORT
Scootering	SPORT
Casterboarding	SPORT
Freeboard (skateboard)	SPORT
Longboarding	SPORT
Streetboarding	SPORT
Skysurfing	SPORT
Streetluge	SPORT
Snowboarding	SPORT
Mountainboarding	SPORT
Sandboarding	SPORT
Snowkiting	SPORT
Surfing	SPORT
Wakesurfing	SPORT
Bodyboarding	SPORT
Riverboarding	SPORT
Skimboarding	SPORT
Windsurfing	SPORT
Wakeboarding	SPORT
Kneeboarding	SPORT
Catch games	SPORT
Dodgeball	SPORT
Ga-ga	SPORT
Keep away	SPORT
Kin-Ball	SPORT
Newcomb ball	SPORT
Quidditch	SPORT
Yukigassen	SPORT
Climbing	SPORT
Canyoning	SPORT
Rock climbing	SPORT
Bouldering	SPORT
Deep-water soloing	SPORT
Sport climbing	SPORT
Traditional climbing	SPORT
Aid climbing	SPORT
Ice climbing	SPORT
Mixed climbing	SPORT
Abseiling	SPORT
Mountaineering	SPORT
Other	SPORT
Canyoning (Canyoneering)	SPORT
Hiking	SPORT
Rope climbing	SPORT
Pole climbing	SPORT
Coasteering	SPORT
Cycling	SPORT
A track cycling Race	SPORT
Bicycle	SPORT
Artistic cycling	SPORT
BMX	SPORT
Cyclo-cross	SPORT
Cross-country mountain biking	SPORT
Cycle polo	SPORT
Cycle speedway	SPORT
Downhill mountain biking	SPORT
Dirt jumping	SPORT
Freestyle BMX	SPORT
Hardcourt Bike Polo	SPORT
Road bicycle racing	SPORT
Track cycling	SPORT
Underwater cycling	SPORT
Skibob	SPORT
Skibobbing	SPORT
Unicycle	SPORT
Unicycling	SPORT
Mountain unicycling	SPORT
Unicycle trials	SPORT
Unicycle hockey	SPORT
Unicycle basketball	SPORT
Combat sports: Wrestling and Martial Arts	SPORT
Main articles: Combat sport and Martial arts	SPORT
Grappling	SPORT
Aiki-jujutsu	SPORT
Aikido	SPORT
Jujutsu	SPORT
Judo	SPORT
Brazilian Jiu-Jitsu	SPORT
Sambo (martial art)	SPORT
Sumo	SPORT
Wrestling	SPORT
Amateur wrestling	SPORT
Greco-Roman wrestling	SPORT
Freestyle wrestling	SPORT
Folk wrestling	SPORT
Boli Khela	SPORT
Collar-and-elbow	SPORT
Cornish Wrestling	SPORT
Dumog	SPORT
Glima	SPORT
Gouren	SPORT
Kurash	SPORT
Lancashire wrestling	SPORT
Catch wrestling	SPORT
Malla-yuddha	SPORT
Mongolian wrestling	SPORT
Pehlwani	SPORT
Professional wrestling	SPORT
Schwingen	SPORT
Shuai Jiao	SPORT
Ssireum	SPORT
Varzesh-e Pahlavani	SPORT
Yagli Güres	SPORT
Greek wrestling	SPORT
Striking	SPORT
Choi Kwang-Do	SPORT
Cockfighting	SPORT
Boxing	SPORT
Bokator	SPORT
Capoeira	SPORT
Fujian White Crane	SPORT
Karate	SPORT
Kenpo	SPORT
Kickboxing	SPORT
Lethwei	SPORT
Muay Thai	SPORT
Pradal serey	SPORT
San shou	SPORT
Savate	SPORT
Shaolin kung fu	SPORT
Sikaran	SPORT
Silat	SPORT
Subak	SPORT
Taekkyeon	SPORT
Taekwondo	SPORT
Taido	SPORT
Tang Soo Do	SPORT
Wing Chun	SPORT
Zui quan	SPORT
Mixed or hybrid	SPORT
Further information: Mixed martial arts	SPORT
Baguazhang	SPORT
Bando	SPORT
Bartitsu	SPORT
Bujinkan	SPORT
Hapkido	SPORT
Hwa Rang Do	SPORT
Jeet Kune Do	SPORT
Kajukenbo	SPORT
Kalarippayattu	SPORT
Krav Maga	SPORT
Kuk Sool Won	SPORT
MCMAP	SPORT
Mixed martial arts	SPORT
Northern Praying Mantis	SPORT
Ninjutsu	SPORT
Pankration	SPORT
Pencak Silat	SPORT
Sanshou	SPORT
Shidokan Karate	SPORT
Shorin-ryu Shidokan	SPORT
Shoot boxing	SPORT
Shootfighting	SPORT
Shorinji Kempo	SPORT
Systema	SPORT
T'ai chi ch'uan	SPORT
Vajra-mushti	SPORT
Vale tudo	SPORT
Vovinam	SPORT
Xingyiquan	SPORT
Weapons	SPORT
Axe throwing at the Ming Culture Village, a theme park near the Yangshan Quarry, China	SPORT
Axe throwing	SPORT
Battojutsu	SPORT
Boffer fighting	SPORT
Eskrima	SPORT
Egyptian stick fencing	SPORT
Fencing	SPORT
Gatka	SPORT
Hojojutsu	SPORT
Iaido	SPORT
Iaijutsu	SPORT
Jodo	SPORT
Jogo do pau	SPORT
Jukendo	SPORT
Juttejutsu	SPORT
Kendo	SPORT
Kenjutsu	SPORT
Krabi-krabong	SPORT
Kung fu	SPORT
Kyudo	SPORT
Kyujutsu	SPORT
Modern Arnis	SPORT
Naginatajutsu	SPORT
Nguni stick-fighting	SPORT
Okinawan kobudo	SPORT
Shurikenjutsu	SPORT
Silambam	SPORT
Sojutsu	SPORT
Sword fighting	SPORT
Wushu	SPORT
Kumdo	SPORT
Wing Chun	SPORT
Skirmish	SPORT
Airsoft	SPORT
Laser tag	SPORT
Paintball	SPORT
Cue sports	SPORT
Pool balls	SPORT
Carom billiards	SPORT
Three-cushion	SPORT
Five-pins	SPORT
Balkline and straight rail	SPORT
Cushion caroms	SPORT
Four-ball (yotsudama)	SPORT
Artistic billiards	SPORT
Novuss (and cued forms of carrom)	SPORT
Pocket billiards (pool)	SPORT
Eight-ball	SPORT
Nine-ball	SPORT
One-pocket	SPORT
Three-ball	SPORT
Seven-ball	SPORT
Ten-ball	SPORT
Rotation	SPORT
Baseball pocket billiards	SPORT
Cribbage (pool)	SPORT
Bank pool	SPORT
Artistic pool	SPORT
Trick shot competition	SPORT
Speed pool	SPORT
Bowlliards	SPORT
Chicago	SPORT
Kelly pool	SPORT
Cutthroat	SPORT
Killer	SPORT
Russian pyramid	SPORT
Snooker	SPORT
Sinuca brasileira	SPORT
Six-red snooker	SPORT
Snooker plus	SPORT
Hybrid carom–pocket games	SPORT
English billiards	SPORT
Bottle pool	SPORT
Cowboy	SPORT
Obstacle variations	SPORT
Bagatelle	SPORT
Bar billiards	SPORT
Bumper pool	SPORT
Table Sports	SPORT
Foosball	SPORT
Equine sports	SPORT
Buzkashi	SPORT
Barrel racing	SPORT
Campdrafting	SPORT
Cirit	SPORT
Charreada	SPORT
Chilean rodeo	SPORT
Cross country	SPORT
Cutting	SPORT
Dressage	SPORT
Endurance riding	SPORT
English pleasure	SPORT
Equitation	SPORT
Eventing	SPORT
Equestrian vaulting	SPORT
Gymkhana	SPORT
Harness racing	SPORT
Horse racing	SPORT
Horseball	SPORT
Hunter	SPORT
Hunter-jumpers	SPORT
Jousting	SPORT
Pato	SPORT
Reining	SPORT
Rodeo	SPORT
Show jumping	SPORT
Steeplechase	SPORT
Team penning	SPORT
Tent pegging	SPORT
Western pleasure	SPORT
Fishing	SPORT
Angling	SPORT
Big-game fishing	SPORT
Casting	SPORT
Noodling	SPORT
Spearfishing	SPORT
Sport fishing	SPORT
Surf fishing	SPORT
Rock fishing	SPORT
Fly fishing	SPORT
Ice fishing	SPORT
Flying disc sports	SPORT
Beach ultimate	SPORT
Disc dog	SPORT
Disc golf	SPORT
Disc golf (urban)	SPORT
Dodge disc	SPORT
Double disc court	SPORT
Flutterguts	SPORT
Freestyle	SPORT
Freestyle competition	SPORT
Goaltimate	SPORT
Guts	SPORT
Hot box	SPORT
Ringo	SPORT
Ultimate	SPORT
Cylinder	SPORT
Football	SPORT
Ancient games	SPORT
Chinlone	SPORT
Cuju	SPORT
Episkyros	SPORT
Harpastum	SPORT
Kemari	SPORT
Ki-o-rahi	SPORT
Marn Grook	SPORT
Woggabaliri	SPORT
Yubi lakpi	SPORT
Medieval football	SPORT
Ba game	SPORT
Caid	SPORT
Calcio Fiorentino	SPORT
Camping (game)	SPORT
Chester-le-Street	SPORT
Cnapan	SPORT
Cornish hurling	SPORT
Haxey Hood	SPORT
Knattleikr	SPORT
La soule	SPORT
Lelo burti	SPORT
Mob football	SPORT
Royal Shrovetide Football	SPORT
Uppies and Downies	SPORT
Association football	SPORT
Jorkyball	SPORT
Paralympic football	SPORT
Powerchair Football	SPORT
Reduced variants	SPORT
Five-a-side football	SPORT
Beach soccer	SPORT
Futebol de Salão	SPORT
Futsal	SPORT
Papi fut	SPORT
Indoor soccer	SPORT
Masters Football	SPORT
Street football	SPORT
Freestyle football	SPORT
Keepie uppie	SPORT
Swamp football	SPORT
Three sided football	SPORT
Australian football	SPORT
Nine-a-side footy	SPORT
Rec footy	SPORT
Metro footy	SPORT
English school games	SPORT
Eton College	SPORT
Field game	SPORT
Wall game	SPORT
Harrow football	SPORT
Gaelic football	SPORT
Ladies' Gaelic football	SPORT
Gridiron football	SPORT
American football	SPORT
Eight-man football	SPORT
Flag football	SPORT
Indoor football	SPORT
Arena football	SPORT
Nine-man football	SPORT
Six-man football	SPORT
Sprint football	SPORT
Touch football	SPORT
Canadian football	SPORT
Street football (American)	SPORT
Rugby football	SPORT
Beach rugby	SPORT
Rugby league	SPORT
Masters Rugby League	SPORT
Mini footy	SPORT
Mod league	SPORT
Rugby league nines	SPORT
Rugby league sevens	SPORT
Tag rugby	SPORT
Touch football	SPORT
Wheelchair rugby league	SPORT
Rugby union	SPORT
American flag rugby	SPORT
Mini rugby	SPORT
Rugby sevens	SPORT
Tag rugby	SPORT
Touch rugby	SPORT
Rugby tens	SPORT
Snow rugby	SPORT
Hybrid codes	SPORT
Austus	SPORT
Eton wall game	SPORT
International rules football	SPORT
Samoa rules	SPORT
Speedball	SPORT
Universal football	SPORT
Volata	SPORT
Golf	SPORT
Match play	SPORT
Skins game	SPORT
Stroke play	SPORT
Team play	SPORT
Shotgun start	SPORT
Speed golf	SPORT
Miniature golf	SPORT
Gymnastics	SPORT
Acrobatic gymnastics	SPORT
Aerobic gymnastics	SPORT
Artistic gymnastics	SPORT
Balance beam	SPORT
Floor	SPORT
High bar	SPORT
Parallel bars	SPORT
Pommel horse	SPORT
Still rings	SPORT
Uneven bars	SPORT
Vault	SPORT
Juggling	SPORT
Rhythmic gymnastics	SPORT
Ball	SPORT
Club	SPORT
Hoop	SPORT
Ribbon	SPORT
Rope	SPORT
Rope jumping	SPORT
Slacklining	SPORT
Trampolining	SPORT
Trapeze	SPORT
Flying trapeze	SPORT
Static trapeze	SPORT
Tumbling	SPORT
Handball family	SPORT
Goalball	SPORT
Tchoukball	SPORT
Team handball	SPORT
Beach handball	SPORT
Czech handball	SPORT
Field handball	SPORT
Torball	SPORT
Water polo	SPORT
hitball	SPORT
Hunting	SPORT
Beagling	SPORT
Big game hunting	SPORT
Deer hunting	SPORT
Fox hunting	SPORT
Hare coursing	SPORT
Wolf hunting	SPORT
Ice sports	SPORT
Bandy	SPORT
Rink bandy	SPORT
Broomball	SPORT
Curling	SPORT
Ice hockey	SPORT
Ringette	SPORT
Ice yachting	SPORT
Figure skating	SPORT
Kite sports	SPORT
Kite buggy	SPORT
Kite fighting	SPORT
Kite landboarding	SPORT
Kitesurfing	SPORT
Parasailing	SPORT
Snow kiting	SPORT
Sport kite (Stunt kite)	SPORT
Mixed discipline	SPORT
Adventure racing	SPORT
Biathlon	SPORT
Duathlon	SPORT
Decathlon	SPORT
Heptathlon	SPORT
Icosathlon	SPORT
Modern pentathlon	SPORT
Pentathlon	SPORT
Tetrathlon	SPORT
Triathlon	SPORT
Woodsman	SPORT
Orienteering family	SPORT
Geocaching	SPORT
Orienteering	SPORT
Rogaining	SPORT
Letterboxing	SPORT
Waymarking	SPORT
Pilota family	SPORT
American handball	SPORT
Australian handball	SPORT
Basque pelota	SPORT
Jai alai	SPORT
Fives	SPORT
Eton Fives	SPORT
Rugby Fives	SPORT
Frisian handball	SPORT
Four square	SPORT
Gaelic handball	SPORT
Jeu de paume	SPORT
Palla	SPORT
Patball	SPORT
Valencian pilota	SPORT
Badminton	SPORT
Ball badminton	SPORT
Basque pelota	SPORT
Frontenis	SPORT
Xare	SPORT
Beach tennis	SPORT
Fives	SPORT
Matkot	SPORT
Padel	SPORT
Paleta Frontón	SPORT
Pelota mixteca	SPORT
Pickleball	SPORT
Platform tennis	SPORT
Qianball	SPORT
Racketlon	SPORT
Racquetball	SPORT
Racquets	SPORT
Real tennis	SPORT
Soft tennis	SPORT
Speed-ball	SPORT
Speedminton	SPORT
Squash	SPORT
Hardball squash	SPORT
Squash tennis	SPORT
Stické	SPORT
Table tennis	SPORT
Tennis	SPORT
Remote control	SPORT
Model aerobatics	SPORT
RC racing	SPORT
Robot combat	SPORT
Slot car racing	SPORT
Rodeo-originated	SPORT
Bullriding	SPORT
Barrel Racing	SPORT
Bronc Riding	SPORT
Saddle Bronc Riding	SPORT
Roping	SPORT
Calf Roping	SPORT
Team Roping	SPORT
Steer Wrestling	SPORT
Goat Tying	SPORT
Running	SPORT
200 meters sprint	SPORT
Endurance	SPORT
5K run	SPORT
10K run	SPORT
Cross-country running	SPORT
Half marathon	SPORT
Marathon	SPORT
Road running	SPORT
Tower running	SPORT
Ultramarathon	SPORT
Sprint	SPORT
Hurdles	SPORT
Sailing	SPORT
Windsurfing	SPORT
Ice yachting	SPORT
Land sailing	SPORT
Land windsurfing	SPORT
Sailing	SPORT
Windsurfing	SPORT
Kiteboarding	SPORT
Dinghy sailing	SPORT
Snow sports	SPORT
Skiing	SPORT
Alpine skiing	SPORT
Cross-country skiing	SPORT
Freestyle skiing	SPORT
Nordic combined	SPORT
Nordic skiing	SPORT
Ski jumping	SPORT
Skijoring	SPORT
Ski touring	SPORT
Speed skiing	SPORT
Telemark skiing	SPORT
Sled sports	SPORT
Bobsleigh	SPORT
Luge	SPORT
Skibobbing	SPORT
Skeleton	SPORT
Toboggan	SPORT
Shooting sports	SPORT
Clay pigeon shooting	SPORT
Skeet shooting	SPORT
Trap shooting	SPORT
Sporting clays	SPORT
Target shooting	SPORT
Field target	SPORT
Fullbore target rifle	SPORT
High power rifle	SPORT
Benchrest shooting	SPORT
Metallic silhouette	SPORT
Practical shooting	SPORT
Cowboy action shooting	SPORT
Metallic silhouette shooting	SPORT
Stacking	SPORT
Card stacking	SPORT
Dice stacking	SPORT
Sport stacking	SPORT
Stick and ball games	SPORT
Hornussen	SPORT
Hockey	SPORT
Hockey	SPORT
Ball hockey	SPORT
Bando	SPORT
Bandy	SPORT
Rink bandy	SPORT
Broomball	SPORT
Moscow broomball	SPORT
Field hockey	SPORT
Indoor field hockey	SPORT
Floorball	SPORT
Ice hockey	SPORT
Pond hockey	SPORT
Power hockey	SPORT
Ringette	SPORT
Sledge hockey	SPORT
Underwater ice hockey	SPORT
Roller hockey	SPORT
Inline hockey	SPORT
Roller hockey (Quad)	SPORT
Skater hockey	SPORT
Rossall Hockey	SPORT
Spongee	SPORT
Street hockey	SPORT
Underwater hockey	SPORT
Unicycle hockey	SPORT
Hurling and shinty	SPORT
Cammag	SPORT
Hurling	SPORT
Camogie	SPORT
Shinty	SPORT
Composite rules shinty-hurling	SPORT
Lacrosse	SPORT
Lacrosse	SPORT
Box lacrosse	SPORT
Field lacrosse	SPORT
Women's lacrosse	SPORT
Intercrosse	SPORT
Polo	SPORT
Polo	SPORT
Bicycle polo	SPORT
Canoe polo	SPORT
Cowboy polo	SPORT
Elephant polo	SPORT
Horse polo	SPORT
Segway polo	SPORT
Yak polo	SPORT
Street sports	SPORT
Free running	SPORT
Freestyle footbag	SPORT
Freestyle football	SPORT
Powerbocking	SPORT
Parkour	SPORT
Scootering	SPORT
Street workout	SPORT
Tag games	SPORT
British bulldogs (American Eagle)	SPORT
Capture the flag	SPORT
Hana Ichi Monme	SPORT
Hide and seek	SPORT
Jugger	SPORT
Kabaddi	SPORT
Kho kho	SPORT
Kick the can	SPORT
Oztag	SPORT
Red rover	SPORT
Tag	SPORT
Walking	SPORT
Hiking	SPORT
Backpacking (wilderness)	SPORT
Racewalking	SPORT
Bushwhacking	SPORT
Walking	SPORT
Wall-and-ball	SPORT
A game of squash	SPORT
American handball	SPORT
Australian handball	SPORT
Basque pelota	SPORT
Butts Up	SPORT
Chinese handball	SPORT
Fives	SPORT
Gaelic handball	SPORT
International fronton	SPORT
Jorkyball	SPORT
Racquetball	SPORT
Squash	SPORT
Squash tennis	SPORT
Suicide (game)	SPORT
Valencian frontó	SPORT
Wallball	SPORT
Wallyball	SPORT
Aquatic & paddle sports	SPORT
Canoeing	SPORT
Canoeing	SPORT
Outrigger canoeing	SPORT
Kayaking	SPORT
Creeking	SPORT
Flyak	SPORT
Freeboating	SPORT
Sea kayaking	SPORT
Squirt boating	SPORT
Surf kayaking	SPORT
Whitewater kayaking	SPORT
Rafting	SPORT
Rafting	SPORT
Rafting	SPORT
White water rafting	SPORT
Rowing	SPORT
Rowing (sport)	SPORT
Gig racing	SPORT
Coastal and ocean rowing	SPORT
Surfboat	SPORT
Single scull	SPORT
Other paddling sports	SPORT
Dragon boat racing	SPORT
Stand up paddle boarding	SPORT
Aquatic ball sports	SPORT
Surface	SPORT
Water polo	SPORT
Canoe polo	SPORT
Waboba	SPORT
Underwater	SPORT
Underwater football	SPORT
Underwater rugby	SPORT
Underwater hockey	SPORT
Competitive swimming	SPORT
Backstroke	SPORT
Breaststroke	SPORT
Butterfly stroke	SPORT
Freestyle swimming	SPORT
Individual medley	SPORT
Synchronized swimming	SPORT
Medley relay	SPORT
Kindred activities	SPORT
Bifins (finswimming)	SPORT
Surface finswimming	SPORT
Subsurface and recreational	SPORT
Apnoea finswimming	SPORT
Aquathlon (underwater wrestling)	SPORT
Freediving	SPORT
Immersion finswimming	SPORT
Scuba diving	SPORT
Spearfishing	SPORT
Snorkelling	SPORT
Sport diving (sport)	SPORT
Underwater hockey	SPORT
Underwater orienteering	SPORT
Underwater photography (sport)	SPORT
Underwater target shooting	SPORT
Diving	SPORT
Diving	SPORT
Cliff diving	SPORT
Weightlifting	SPORT
Basque traditional weightlifting	SPORT
Bodybuilding	SPORT
Highland games	SPORT
Olympic weightlifting	SPORT
Powerlifting	SPORT
Strength athletics (strongman)	SPORT
Steinstossen	SPORT
Motorized sports	SPORT
Auto racing	SPORT
Autograss	SPORT
Banger racing	SPORT
Board track racing	SPORT
Demolition derby	SPORT
Desert racing	SPORT
Dirt track racing	SPORT
Drag racing	SPORT
Drifting	SPORT
Folkrace	SPORT
Formula racing	SPORT
Formula Libre	SPORT
Formula Student	SPORT
Hillclimbing	SPORT
Ice racing	SPORT
Kart racing	SPORT
Land speed records	SPORT
Legends car racing	SPORT
Midget car racing	SPORT
Monster truck	SPORT
Mud bogging	SPORT
Off-road racing	SPORT
Pickup truck racing	SPORT
Production car racing	SPORT
Race of Champions	SPORT
Rally raid	SPORT
Rallycross	SPORT
Rallying	SPORT
Regularity rally	SPORT
Road racing	SPORT
Short track motor racing	SPORT
Snowmobile racing	SPORT
Sports car racing	SPORT
Sprint car racing	SPORT
Street racing	SPORT
Stock car racing	SPORT
Time attack	SPORT
Tractor pulling	SPORT
Touring car racing	SPORT
Truck racing	SPORT
Vintage racing	SPORT
Wheelstand competition	SPORT
Motorboat racing	SPORT
Drag boat racing	SPORT
F1 powerboat racing	SPORT
Hydroplane racing	SPORT
Jet sprint boat racing	SPORT
Offshore powerboat racing	SPORT
Personal water craft	SPORT
Motorcycle racing	SPORT
MotoGP racing	SPORT
Auto Race	SPORT
Board track racing	SPORT
Cross-country rally	SPORT
Endurance racing	SPORT
Enduro	SPORT
Freestyle motocross	SPORT
Grand Prix motorcycle racing	SPORT
Grasstrack	SPORT
Hillclimbing	SPORT
Ice racing	SPORT
Ice speedway	SPORT
Indoor enduro	SPORT
Motocross	SPORT
Motorcycle drag racing	SPORT
Motorcycle speedway	SPORT
Off-roading	SPORT
Rally raid	SPORT
Road racing	SPORT
Superbike racing	SPORT
Supercross	SPORT
Supermoto	SPORT
Supersport racing	SPORT
Superside	SPORT
Track racing	SPORT
Trial	SPORT
TT racing	SPORT
Free-style moto	SPORT
ATV racing	SPORT
ATV racing on a motocross track	SPORT
All-terrain vehicle competition	SPORT
Marker sports	SPORT
Airsoft	SPORT
Archery	SPORT
Paintball	SPORT
Darts	SPORT
Musical sports	SPORT
Color guard (flag spinning)	SPORT
Drum corps	SPORT
Indoor percussion	SPORT
Marching band	SPORT
Fantasy Sports	SPORT
Quidditch	SPORT
Hunger Games(Gladiating)	SPORT
Pod Racing	SPORT
Mortal Kombat(MMA)	SPORT
Imaginary Sports	SPORT
Cylinder	SPORT
Stairball	SPORT
Wrangleball	SPORT
Other	SPORT
Stihl Timbersports Series	SPORT
Overlapping sports	SPORT
Tennis	SPORT
Polocrosse	SPORT
Badminton	SPORT
Polo	SPORT
Mind sports	SPORT
Card games	SPORT
Other	SPORT
Debating	SPORT
Quizzing	SPORT
Speedcubing	SPORT
Speedcubing	SPORT
2x2x2	SPORT
3x3x3	SPORT
4x4x4	SPORT
5x5x5	SPORT
6x6x6	SPORT
7x7x7	SPORT
Strategy board games	SPORT
Arimaa	SPORT
Backgammon	SPORT
Chess	SPORT
Losing chess	SPORT
Checkers	SPORT
Chinese checkers	SPORT
Diplomacy	SPORT
Dominoes	SPORT
Draughts	SPORT
Go	SPORT
Go-Moku	SPORT
Jacquet	SPORT
Mancala	SPORT
Mahjong	SPORT
Risk	SPORT
Scrabble	SPORT
Shogi	SPORT
Sholo Guti	SPORT
Sogo (Score four)	SPORT
Stratego	SPORT
Sudoku	SPORT
Xiangqi (Chinese chess)	SPORT
Competitive model sports	SPORT
Model aircraft racing	SPORT
Model yacht racing	SPORT
Neppis	SPORT
Slot car racing	SPORT
Different classification	SPORT
Air sports	SPORT
Banzai skydiving	SPORT
Bungee jumping	SPORT
Hot air ballooning	SPORT
Athletics (track and field)	SPORT
Pole vault	SPORT
Steeplechase	SPORT
Cross country	SPORT
Jumping	SPORT
Triple jump	SPORT
Long jump	SPORT
High jump	SPORT
Pole vault	SPORT
Throwing	SPORT
Discus	SPORT
Hammer throw	SPORT
Javelin	SPORT
Shot put	SPORT
Racewalking	SPORT
Electronic sports	SPORT
Combat robot	SPORT
Contesting	SPORT
Geo caching	SPORT
Radio-control vehicles	SPORT
Endurance sports	SPORT
Chariot racing	SPORT
Cross-country skiing	SPORT
Running	SPORT
Cycling	SPORT
Rowing	SPORT
Swimming	SPORT
Wheelchair racing	SPORT
Wood chopping	SPORT
Goal sports	SPORT
Basketball family	SPORT
Football family	SPORT
Handball family	SPORT
Hockey family	SPORT
Lacrosse	SPORT
Polo	SPORT
Performance sports	SPORT
Marching band[2][3][4]	SPORT
Drum corps	SPORT
Skating sports	SPORT
Aggressive inline skating	SPORT
Artistic roller skating	SPORT
Figure skating	SPORT
Freestyle slalom skating	SPORT
Ice dancing	SPORT
Ice skating	SPORT
Inline speed skating	SPORT
Rinkball	SPORT
Rink hockey	SPORT
Roller derby	SPORT
Roller skating	SPORT
Short track speed skating	SPORT
Skater hockey	SPORT
Speed skating	SPORT
Synchronized skating	SPORT
Snowsports	SPORT
A snowboarder and a skier	SPORT
A ski jumper using the V-style	SPORT
Boardercross	SPORT
Freestyle snowboarding	SPORT
Freestyle skiing	SPORT
Snowboarding	SPORT
Ski flying	SPORT
Skibob	SPORT
Snowshoeing	SPORT
Skiboarding	SPORT
See #Skiing	SPORT
Strength sports	SPORT
Arm wrestling	SPORT
Arm wrestling	SPORT
Olympic weightlifting	SPORT
Powerlifting	SPORT
Rock climbing	SPORT
Strongman	SPORT
Thumb wrestling	SPORT
Toe wrestling	SPORT
Tug-o-war	SPORT
Wood chopping	SPORT
Wood splitting	SPORT
Zourkhaneh	SPORT
Table sports	SPORT
Air hockey	SPORT
Backgammon	SPORT
Beer Pong	SPORT
Connect Four	SPORT
Cue sports	SPORT
Dominoes	SPORT
Headis	SPORT
Janggi	SPORT
Shogi	SPORT
Scrabble	SPORT
Subbuteo	SPORT
Table football	SPORT
Table hockey	SPORT
Xiangqi	SPORT
Target sports	SPORT
Archery	SPORT
Axe throwing	SPORT
Bocce	SPORT
Bocce volo	SPORT
Boccia	SPORT
Bolas criollas	SPORT
Boules	SPORT
Bowling	SPORT
Calva	SPORT
Cornhole	SPORT
Croquet	SPORT
Cue sports	SPORT
Darts	SPORT
Golf	SPORT
Kubb	SPORT
Matball	SPORT
Pall mall	SPORT
Pétanque	SPORT
Pitch and putt	SPORT
Shooting	SPORT
Shuffleboard	SPORT
Skittles	SPORT
Skee ball	SPORT
Trugo	SPORT
Woodball	SPORT
Team sports	SPORT
Match of lacrosse	SPORT
Basketball family	SPORT
Bat and ball games	SPORT
Bowling	SPORT
Basque pelota	SPORT
Bunnock	SPORT
Camogie	SPORT
Football family	SPORT
Gateball	SPORT
Gaelic football	SPORT
Handball	SPORT
Hardcourt Bike Polo	SPORT
Hockey family	SPORT
Horseshoe	SPORT
Hurling	SPORT
Kickball	SPORT
Lacrosse	SPORT
Mesoamerican ballgame	SPORT
Newcomb ball	SPORT
Polo	SPORT
Paintball	SPORT
Quidditch	SPORT
Ringette	SPORT
Rowing	SPORT
Sepak takraw	SPORT
Ultimate (sport)	SPORT
Underwater football	SPORT
Woodsman	SPORT
Volleyball	SPORT
Windsports	SPORT
Kite flying	SPORT
Parachuting	SPORT
Hot Air Balloon Racing	SPORT
Fictional sports	SPORT
43-Man Squamish	SPORT
Calvinball	SPORT
Quidditch (Harry Potter)	SPORT
Guyball	SPORT
Miscellaneous sports	SPORT
Logrolling	SPORT
Chess boxing	SPORT
Competitive eating	SPORT
Egg and spoon race	SPORT
Extreme ironing	SPORT
Ferret legging	SPORT
Footbag (hacky sack)	SPORT
Haggis hurling	SPORT
Lumberjack sports	SPORT
Aizkolaritza	SPORT
Axe throwing	SPORT
Logrolling	SPORT
Wood chopping	SPORT
Wood splitting	SPORT
Patball	SPORT
Ringette	SPORT
Sack race	SPORT
Soap shoes	SPORT
Tennikoit	SPORT
Tetherball	SPORT
Three-legged race	SPORT
Wallball	SPORT
Wife-carrying	SPORT
Object spinning	SPORT
Plate spinning	SPORT
Padiddling	SPORT